Title:  Keyboard Shortcuts

Seq:    36

Tags:   keys, shortcuts

Body:   
 
Following are the keyboard shortcuts available within the app. Tap the appropriate modifier key for your computer (CMD for a Mac), and then combine with a letter, number or symbol indicated below. 

* B - Backup
* C - Copy
* D - Delete Note
* E - Open Essential Collection
* F - Find
* G - Get File Info
* H - Hide Notenik
* I - Increment Date or Seq
* J - Jump to Last Collection
* K - Close Note
* L - Link Tweaker
* M - Open Master Collection
* N - New Note
* O - Open
* P - Publish
* Q - Quit Notenik
* R - Replace
* S - Save
* T - Text Edit Note
* V - Paste
* W - Reduce Window Size
* X - Cut
* Z - Undo Edits
* 1 - Sort by Title
* 2 - Sort by Seq + Title
* 3 - Sort Tasks by Date
* 4 - Sort Tasks by Seq
* , - Notenik Preferences
* [ - Prior Note
* ]  - Next Note


